#################################################################################################################################################################################################################################################################################################################################################################################################################################################################################################################################################
#                                                                                                                                                                                                                                                                                                                                                                                                                                                                                                                                               #
#                                                                                                                                                                                                                                                                                                                                                                                                                                                                                                                                               #
#                                                                                                                                                                                                                                                                                                                                                                                                                                                                                                                    ####|                      #
#                                                                                                                                                                                                                                                                                                                                                                                                                                                                                                                  ######|                      #
#                                                                                                                                                                                                                                                                                                                                                                                                                                                                                                                        |                      #
#                                                                                                                                                                                                                                                                                                                 ##############################                ###############                                                                                                                                        #/#\#                    #
#                                                                                                                                                                                                                                                                                                                 ##############################                ###############                                                                                                                                       #/###\#                   #
#                                                                                                                                                                                                                                                                                                                 ##############################                ###############                                                                                                                                      #/#####\#                  #
#                                                                                                                                                                                                                                                                                                                                                                                                                                                                                                                   #/#######\#                 #
#                                                                                                                                                                                                                    ###############                                                                                                                                                                                                                                                                               #/#########\#                #
#                                                                                                                                                                                                                    ###############                                                                                                                                                                                                                                                                              #/###########\#               #
#                                                                                                                                                                                                                    ###############                                                                                                                                                                                                                                                                             ##|##|||#|||##|##              #
#                                                                                                                                                                                                                                                                                                                                                                                                                                                                                                                ##|##|||#|||##|##              #
#                                                                                                                                                                                                                                                                                                                                                                                                                                                                                                                ##|##|||#|||##|##              #
#                                                                                                                                                                                                                                                                                                       #####MMMMM#####                                 #####                                                                                #########                                                           ##|##||###||##|##              #
#                                                                                                                                                                                                             #####                                                                                     #####M ? M#####                                 #####                                                                             ############                                                           ##|##|#####|##|##              #
#                                              %%%%%%%%%%%                                                                                                                                                    #####                                                                                     #####MMMMM#####                                 #####                                                                          ###############                                                   #################################      #
#                                              %%%%%%%%%%%                                                                                               %%%%%%%%%%%                                          #####                                                                                                                                                                                                                 ##################                                                   |||## ##|||###########|||## ##|||      #
#                                                %%%%%%%                                                 %%%%%%%%%%%                                     %%%%%%%%%%%                                                                                                                                                                                                                                                             #####################                                                   |||#   #|||###     ###|||#   #|||      #
#                                                %%%%%%%                                                 %%%%%%%%%%%                                       %%%%%%%                                                                                                                                                                                                                                                            ########################                                                   |||     |||##       ##|||     |||      #
#                                                %%%%%%%                                                   %%%%%%%                                         %%%%%%%                                                                                ####                                                                                                                                                                     ###########################                                                   |||     |||#   |||   #|||     |||      #
#                                                %%%%%%%                                                   %%%%%%%                                         %%%%%%%                                                                                ######                                                                                                                                                                ##############################                                                   |||     |||   |   |   |||     |||      #
#                                                %%%%%%%                                                   %%%%%%%                                         %%%%%%%                                                                                ########                                                                                                                                                           #################################                                                   |||     |||   |" "|   |||     |||      #
##################################################################################################################################################################################################        ###########        #############        ###############################################################################################################################################################################################################################################################################################
#                                                                                                                                                                                                                                                                                                                                                                                                                                                                                                                                               #
#                                                                                                                                                                                                                                                                                                                                                                                                                                                                                                                                               #
-------------------------------------------------------------------------------------------------------------------------------------------------------------------------------------------------------------------------------------------------------------------------------------------------------------------------------------------------------------------------------------------------------------------------------------------------------------------------------------------------------------------------------------------------